1111111
1P00001
100E001
10110C1
1111111