1111111
1P00001
101E0C1
10001C1
1111111