1111111
1P00001
100E001
10000C1
1111111