1111111
10011E1
111P001
11C1111
1111111