1111111
1000001
100P001
10C00E1
1111111