1111111
100E001
111P001
11C1111
1111611