11111111111111111111
10000000000000000001
10000000000000000001
10000000000010000001
10001111000000000001
10000000000000000001
10000000000P00000001
10000100000000000001
10000000000000000001
10001100000000100001
10000000000001C10011
1000000010000E010001
10000001010000000001
10000000001000000001
10000000011000000011
11111111111111111111
