9ZZZZZZZZZZZZZZ9
1PC1111111111111
11E1112111111111
1111113111111111
1111124111111111
1111115111111111
1111126111111111
1111117111111111
1111241111111111
1111115111111111
1111126111111111
1111117111111111
1111241111111111
1111115111111111
1111126111111111
1111241111111111
1111115111111111
1111126111111111
